10 10
########**
########**
#######**#
##899***##
##7****###
##*****###
#**4######
#*########
*3########
95########