10 10
########**
########**
#######**#
##******##
##*****###
##*****###
#***######
#*########
**########
**########